11111111111111111111111
1C000000000000100000001
1000000000000000000C001
11011100H0111100C000001
1E00000000111100000F001
111111110H011100P000001
10000000000001000000001
10C00000000001000000001
11011100H0111100000C001
10000000000C00000000001
11111111111111111111111